the	DET
be	AUX
and	CCONJ
a	DET
you	PRON
it	PRON
have	VERB
I	PRON
he	PRON
that	SCONJ
or	CCONJ
your	PRON
that	PRON
his	PRON
an	DET
can	AUX
but	CCONJ
will	AUX
they	PRON
this	DET
do	AUX
which	PRON
if	SCONJ
we	PRON
be	VERB
say	VERB
make	VERB
their	PRON
also	ADV
use	VERB
when	SCONJ
as	SCONJ
her	PRON
time	NOUN
do	VERB
who	PRON
she	PRON
other	ADJ
take	VERB
would	AUX
get	VERB
go	VERB
so	ADV
them	PRON
this	PRON
good	ADJ
people	NOUN
see	VERB
know	VERB
year	NOUN
my	PRON
its	PRON
him	PRON
more	ADV
all	PRON
some	DET
there	PRON
then	ADV
where	SCONJ
think	VERB
come	VERB
what	PRON
may	AUX
find	VERB
these	DET
how	SCONJ
no	DET
could	AUX
our	PRON
first	ADJ
very	ADV
include	VERB
only	ADV
day	NOUN
way	NOUN
just	ADV
as	ADV
give	VERB
such	ADJ
me	PRON
many	ADJ
should	AUX
any	DET
that	DET
want	VERB
well	ADV
area	NOUN
need	VERB
most	ADV
city	NOUN
all	DET
image	NOUN
look	VERB
high	ADJ
There	PRON
now	ADV
new	ADJ
man	NOUN
life	NOUN
while	SCONJ
because	SCONJ
thing	NOUN
of	SCONJ
become	VERB
however	ADV
part	NOUN
great	ADJ
work	VERB
show	VERB
work	NOUN
large	ADJ
small	ADJ
country	NOUN
by	SCONJ
even	ADV
study	NOUN
follow	VERB
in	SCONJ
system	NOUN
different	ADJ
leave	VERB
place	NOUN
try	VERB
help	VERB
run	VERB
more	ADJ
child	NOUN
same	ADJ
number	NOUN
old	ADJ
much	ADV
call	VERB
tell	VERB
water	NOUN
service	NOUN
town	NOUN
government	NOUN
keep	VERB
here	ADV
family	NOUN
still	ADV
for	SCONJ
several	ADJ
feel	VERB
start	VERB
ask	VERB
own	ADJ
back	ADV
consider	VERB
name	NOUN
there	ADV
important	ADJ
provide	VERB
each	DET
step	NOUN
world	NOUN
What	PRON
local	ADJ
lead	VERB
after	SCONJ
home	NOUN
before	SCONJ
issue	NOUN
group	NOUN
every	DET
write	VERB
most	ADJ
last	ADJ
might	AUX
few	ADJ
result	NOUN
information	NOUN
hold	VERB
state	NOUN
put	VERB
process	NOUN
food	NOUN
bring	VERB
serve	VERB
case	NOUN
level	NOUN
another	DET
minute	NOUN
member	NOUN
side	NOUN
us	PRON
about	ADV
method	NOUN
book	NOUN
point	NOUN
hand	NOUN
too	ADV
low	ADJ
car	NOUN
bus	NOUN
woman	NOUN
die	VERB
hour	NOUN
never	ADV
must	AUX
allow	VERB
increase	VERB
live	VERB
model	NOUN
far	ADV
why	SCONJ
play	VERB
party	NOUN
lot	NOUN
something	NOUN
always	ADV
some	PRON
datum	NOUN
due	ADJ
second	ADJ
add	VERB
mean	VERB
base	VERB
line	NOUN
create	VERB
next	ADJ
order	NOUN
main	ADJ
late	ADV
problem	NOUN
little	ADJ
really	ADV
understand	VERB
train	NOUN
build	VERB
often	ADV
believe	VERB
end	NOUN
offer	VERB
dog	NOUN
death	NOUN
person	NOUN
example	NOUN
big	ADJ
other	NOUN
power	NOUN
let	VERB
long	ADJ
continue	VERB
site	NOUN
long	ADV
require	VERB
house	NOUN
read	VERB
free	ADJ
both	DET
choose	VERB
begin	VERB
region	NOUN
set	VERB
seem	VERB
friend	NOUN
again	ADV
speak	VERB
effect	NOUN
receive	VERB
early	ADJ
community	NOUN
move	VERB
business	NOUN
station	NOUN
young	ADJ
possible	ADJ
research	NOUN
eye	NOUN
change	NOUN
school	NOUN
those	PRON
turn	VERB
although	SCONJ
value	NOUN
involve	VERB
month	NOUN
road	NOUN
talk	VERB
use	NOUN
pay	VERB
those	DET
like	VERB
grow	VERB
company	NOUN
activity	NOUN
develop	VERB
report	VERB
change	VERB
night	NOUN
kill	VERB
head	NOUN
political	ADJ
available	ADJ
able	ADJ
reach	VERB
stand	VERB
team	NOUN
major	ADJ
election	NOUN
event	NOUN
win	VERB
type	NOUN
game	NOUN
energy	NOUN
right	NOUN
son	NOUN
health	NOUN
public	ADJ
buy	VERB
condition	NOUN
pass	VERB
learn	VERB
development	NOUN
stop	VERB
room	NOUN
money	NOUN
week	NOUN
least	ADJ
lose	VERB
yourself	PRON
cause	VERB
since	SCONJ
position	NOUN
return	VERB
word	NOUN
remain	VERB
appear	VERB
close	ADJ
walk	VERB
easy	ADJ
cell	NOUN
candidate	NOUN
paper	NOUN
control	NOUN
question	NOUN
report	NOUN
so	SCONJ
light	NOUN
boat	NOUN
himself	PRON
experience	NOUN
language	NOUN
history	NOUN
ever	ADV
idea	NOUN
support	VERB
interest	NOUN
together	ADV
law	NOUN
describe	VERB
whether	SCONJ
material	NOUN
especially	ADV
term	NOUN
island	NOUN
happen	VERB
plant	NOUN
apply	VERB
once	ADV
accord	SCONJ
less	ADV
locate	VERB
role	NOUN
though	SCONJ
land	NOUN
first	ADV
meet	VERB
until	SCONJ
send	VERB
today	NOUN
cut	VERB
body	NOUN
animal	NOUN
therefore	ADV
reduce	VERB
source	NOUN
relate	VERB
course	NOUN
reason	NOUN
social	ADJ
century	NOUN
project	NOUN
field	NOUN
hear	VERB
cover	VERB
fact	NOUN
interview	NOUN
improve	VERB
village	NOUN
eat	VERB
air	NOUN
campaign	NOUN
building	NOUN
office	NOUN
action	NOUN
current	ADJ
open	ADJ
response	NOUN
rather	ADV
human	ADJ
almost	ADV
goal	NOUN
represent	VERB
market	NOUN
carry	VERB
away	ADV
thus	ADV
force	NOUN
late	ADJ
view	NOUN
bear	VERB
sit	VERB
performance	NOUN
expect	VERB
both	CCONJ
perform	VERB
various	ADJ
full	ADJ
factor	NOUN
publish	VERB
bad	ADJ
cost	NOUN
network	NOUN
population	NOUN
yet	ADV
marry	VERB
usually	ADV
obtain	VERB
&	CCONJ
period	NOUN
kind	NOUN
property	NOUN
rate	NOUN
already	ADV
strong	ADJ
analysis	NOUN
face	NOUN
determine	VERB
product	NOUN
leader	NOUN
art	NOUN
support	NOUN
quality	NOUN
father	NOUN
media	NOUN
visit	VERB
center	NOUN
at	ADV
anything	NOUN
music	NOUN
form	NOUN
probably	ADV
court	NOUN
set	NOUN
spend	VERB
attack	NOUN
enter	VERB
nothing	NOUN
job	NOUN
only	ADJ
space	NOUN
remove	VERB
war	NOUN
suggest	VERB
similar	ADJ
Figure	NOUN
age	NOUN
park	NOUN
sure	ADJ
risk	NOUN
addition	NOUN
website	NOUN
white	ADJ
produce	VERB
piece	NOUN
name	VERB
yes	INTJ
international	ADJ
street	NOUN
account	NOUN
military	ADJ
common	ADJ
foot	NOUN
amount	NOUN
over	ADV
mother	NOUN
national	ADJ
tip	NOUN
approach	NOUN
daughter	NOUN
plan	NOUN
present	VERB
surface	NOUN
airport	NOUN
affect	VERB
application	NOUN
enough	ADV
certain	ADJ
place	VERB
patient	NOUN
article	NOUN
stay	VERB
well	INTJ
compare	VERB
remember	VERB
option	NOUN
decision	NOUN
policy	NOUN
right	ADJ
identify	VERB
km	NOUN
former	ADJ
right	ADV
student	NOUN
form	VERB
police	NOUN
girl	NOUN
video	NOUN
difference	NOUN
flight	NOUN
soon	ADV
fall	VERB
someone	NOUN
mind	NOUN
quite	ADV
real	ADJ
top	NOUN
connect	VERB
restaurant	NOUN
price	NOUN
little	ADV
focus	VERB
prepare	VERB
door	NOUN
environment	NOUN
from	SCONJ
sometimes	ADV
break	VERB
popular	ADJ
open	VERB
contain	VERB
care	NOUN
operate	VERB
ride	NOUN
program	NOUN
route	NOUN
design	NOUN
relationship	NOUN
solution	NOUN
claim	VERB
need	NOUN
table	NOUN
wait	VERB
oil	NOUN
short	ADJ
study	VERB
no	INTJ
specie	NOUN
propose	VERB
raise	VERB
church	NOUN
feature	NOUN
watch	VERB
function	NOUN
these	PRON
bit	NOUN
distance	NOUN
capital	NOUN
class	NOUN
state	VERB
share	VERB
temperature	NOUN
effort	NOUN
whole	ADJ
sell	VERB
security	NOUN
previous	ADJ
actually	ADV
wall	NOUN
pet	NOUN
lie	VERB
ground	NOUN
production	NOUN
film	NOUN
organization	NOUN
decide	VERB
plan	VERB
structure	NOUN
size	NOUN
arrive	VERB
technology	NOUN
join	VERB
end	VERB
mile	NOUN
on	SCONJ
tree	NOUN
occur	VERB
summer	NOUN
record	NOUN
half	NOUN
drive	VERB
travel	VERB
wife	NOUN
parent	NOUN
specific	ADJ
career	NOUN
hard	ADJ
moment	NOUN
black	ADJ
enjoy	VERB
artist	NOUN
release	VERB
show	NOUN
president	NOUN
location	NOUN
Many	ADJ
everything	NOUN
brother	NOUN
associate	VERB
difficult	ADJ
instead	ADV
prevent	VERB
address	VERB
range	NOUN
situation	NOUN
significant	ADJ
industry	NOUN
morning	NOUN
establish	VERB
attention	NOUN
rule	NOUN
beach	NOUN
select	VERB
exist	VERB
avoid	VERB
save	VERB
resource	NOUN
either	CCONJ
disease	NOUN
official	NOUN
note	VERB
store	NOUN
matter	NOUN
such	PRON
face	VERB
training	NOUN
centre	NOUN
traditional	ADJ
close	VERB
particular	ADJ
love	VERB
miss	VERB
ship	NOUN
result	VERB
likely	ADJ
trip	NOUN
color	NOUN
natural	ADJ
statement	NOUN
knowledge	NOUN
nation	NOUN
degree	NOUN
shop	NOUN
border	NOUN
voice	NOUN
opportunity	NOUN
regard	VERB
culture	NOUN
single	ADJ
simple	ADJ
early	ADV
letter	NOUN
whose	PRON
sea	NOUN
necessary	ADJ
hotel	NOUN
explain	VERB
sport	NOUN
depend	VERB
sign	NOUN
else	ADV
series	NOUN
clear	ADJ
indicate	VERB
boy	NOUN
treatment	NOUN
test	NOUN
author	NOUN
achieve	VERB
nature	NOUN
direction	NOUN
observe	VERB
third	ADJ
impact	NOUN
itself	PRON
announce	VERB
all	ADV
both	PRON
growth	NOUN
computer	NOUN
window	NOUN
without	SCONJ
rest	NOUN
match	NOUN
once	SCONJ
American	ADJ
protect	VERB
date	NOUN
stage	NOUN
tourist	NOUN
recent	ADJ
wear	VERB
safe	ADJ
style	NOUN
themselves	PRON
tool	NOUN
private	ADJ
present	ADJ
general	ADJ
education	NOUN
resident	NOUN
content	NOUN
list	NOUN
plane	NOUN
story	NOUN
board	NOUN
message	NOUN
chance	NOUN
strategy	NOUN
practice	NOUN
special	ADJ
around	ADV
province	NOUN
below	ADV
recently	ADV
currently	ADV
authority	NOUN
season	NOUN
whom	PRON
news	NOUN
economic	ADJ
multiple	ADJ
active	ADJ
environmental	ADJ
page	NOUN
vehicle	NOUN
choice	NOUN
arm	NOUN
sense	NOUN
poor	ADJ
ticket	NOUN
safety	NOUN
access	NOUN
generally	ADV
fill	VERB
conduct	VERB
directly	ADV
personal	ADJ
loss	NOUN
vote	NOUN
technique	NOUN
draw	VERB
mention	VERB
river	NOUN
mountain	NOUN
beautiful	ADJ
challenge	NOUN
ensure	VERB
act	VERB
define	VERB
traffic	NOUN
device	NOUN
operation	NOUN
heart	NOUN
wide	ADJ
management	NOUN
character	NOUN
finally	ADV
purpose	NOUN
section	NOUN
pressure	NOUN
evidence	NOUN
famous	ADJ
investigate	VERB
climate	NOUN
easily	ADV
promote	VERB
score	VERB
get	AUX
speed	NOUN
fire	NOUN
no	ADV
algorithm	NOUN
true	ADJ
front	NOUN
influence	NOUN
base	NOUN
connection	NOUN
introduction	NOUN
past	ADJ
detail	NOUN
particularly	ADV
interview	VERB
further	ADJ
discuss	VERB
dead	ADJ
individual	NOUN
movement	NOUN
fail	VERB
floor	NOUN
destination	NOUN
warning	NOUN
hope	VERB
limit	VERB
nuclear	ADJ
card	NOUN
introduce	VERB
drug	NOUN
opinion	NOUN
winter	NOUN
answer	VERB
press	NOUN
behavior	NOUN
appoint	VERB
perhaps	ADV
one	NOUN
sort	NOUN
than	SCONJ
seat	NOUN
simply	ADV
key	ADJ
machine	NOUN
trade	NOUN
box	NOUN
subject	NOUN
original	ADJ
variety	NOUN
soil	NOUN
much	ADJ
player	NOUN
concern	NOUN
star	NOUN
accord	VERB
agree	VERB
alone	ADV
charge	NOUN
complete	VERB
citizen	NOUN
investigation	NOUN
online	ADV
accept	VERB
king	NOUN
rise	VERB
bar	NOUN
check	VERB
positive	ADJ
seek	VERB
expression	NOUN
flow	NOUN
attend	VERB
final	ADJ
driver	NOUN
Go	VERB
sound	NOUN
potential	ADJ
communication	NOUN
ago	ADV
element	NOUN
oh	INTJ
band	NOUN
effective	ADJ
attempt	NOUN
gas	NOUN
mass	NOUN
maintain	VERB
design	VERB
express	VERB
weapon	NOUN
photo	NOUN
ability	NOUN
measure	VERB
district	NOUN
note	NOUN
surround	VERB
presence	NOUN
visitor	NOUN
painting	NOUN
myself	PRON
happy	ADJ
pattern	NOUN
tour	NOUN
vote	VERB
discover	VERB
physical	ADJ
elect	VERB
finish	VERB
everyone	NOUN
corner	NOUN
manage	VERB
ball	NOUN
troop	NOUN
back	NOUN
confirm	VERB
parameter	NOUN
hot	ADJ
user	NOUN
sample	NOUN
central	ADJ
official	ADJ
entire	ADJ
component	NOUN
round	NOUN
picture	NOUN
north	ADV
heat	NOUN
indeed	ADV
mainly	ADV
figure	NOUN
Spanish	ADJ
contribute	VERB
recognize	VERB
paint	NOUN
future	NOUN
deep	ADJ
spot	NOUN
task	NOUN
marriage	NOUN
signal	NOUN
map	NOUN
mostly	ADV
file	NOUN
edge	NOUN
foreign	ADJ
force	VERB
object	NOUN
green	ADJ
explore	VERB
gene	NOUN
cold	ADJ
daily	ADV
what	DET
red	ADJ
quickly	ADV
officer	NOUN
measure	NOUN
catch	VERB
coast	NOUN
modern	ADJ
governor	NOUN
urban	ADJ
direct	ADJ
minister	NOUN
society	NOUN
increase	NOUN
attempt	VERB
customer	NOUN
concern	VERB
fine	ADJ
nice	ADJ
encourage	VERB
meeting	NOUN
staff	NOUN
feature	VERB
threat	NOUN
length	NOUN
peace	NOUN
track	NOUN
supply	NOUN
infection	NOUN
experience	VERB
treat	VERB
discussion	NOUN
blood	NOUN
serious	ADJ
reaction	NOUN
demonstrate	VERB
global	ADJ
future	ADJ
title	NOUN
path	NOUN
wish	VERB
rock	NOUN
skill	NOUN
unique	ADJ
gain	VERB
trail	NOUN
previously	ADV
walk	NOUN
target	NOUN
sleep	NOUN
individual	ADJ
item	NOUN
museum	NOUN
race	NOUN
aspect	NOUN
collection	NOUN
evaluate	VERB
public	NOUN
return	NOUN
reference	NOUN
crime	NOUN
sign	VERB
highly	ADV
travel	NOUN
branch	NOUN
mechanism	NOUN
post	NOUN
facility	NOUN
complex	ADJ
link	NOUN
consist	VERB
regular	ADJ
successful	ADJ
vary	VERB
platform	NOUN
army	NOUN
couple	NOUN
legal	ADJ
ready	ADJ
maybe	ADV
measurement	NOUN
refer	VERB
forest	NOUN
drink	NOUN
throw	VERB
interesting	ADJ
any	PRON
release	NOUN
trial	NOUN
fish	NOUN
influence	VERB
order	VERB
garden	NOUN
concentration	NOUN
respond	VERB
review	NOUN
pull	VERB
soldier	NOUN
Russian	ADJ
another	PRON
advantage	NOUN
responsible	ADJ
heavy	ADJ
generate	VERB
demand	NOUN
though	ADV
herself	PRON
weight	NOUN
worker	NOUN
bed	NOUN
concept	NOUN
phone	NOUN
completely	ADV
visit	NOUN
cross	VERB
paint	VERB
transport	NOUN
flower	NOUN
nearly	ADV
Q	NOUN
guide	NOUN
Yeah	INTJ
incident	NOUN
wind	NOUN
lack	NOUN
clean	ADJ
lake	NOUN
newspaper	NOUN
listen	VERB
blue	ADJ
distribution	NOUN
deal	NOUN
speech	NOUN
shall	AUX
relation	NOUN
independent	ADJ
northern	ADJ
thought	NOUN
purchase	VERB
recommend	VERB
error	NOUN
sun	NOUN
owner	NOUN
combine	VERB
manner	NOUN
top	ADJ
song	NOUN
cause	NOUN
council	NOUN
general	NOUN
additional	ADJ
numerous	ADJ
hill	NOUN
worth	ADJ
phase	NOUN
with	SCONJ
horse	NOUN
dark	ADJ
search	NOUN
European	ADJ
engage	VERB
background	NOUN
movie	NOUN
downtown	NOUN
ahead	ADV
hospital	NOUN
interaction	NOUN
victim	NOUN
primary	ADJ
online	ADJ
hang	VERB
economy	NOUN
push	VERB
tax	NOUN
yesterday	NOUN
document	NOUN
each	PRON
moreover	ADV
apartment	NOUN
benefit	NOUN
care	VERB
bank	NOUN
about	SCONJ
stress	NOUN
enough	ADJ
professional	ADJ
respect	NOUN
taxis	NOUN
teach	VERB
conference	NOUN
director	NOUN
list	VERB
federal	ADJ
bridge	NOUN
pick	VERB
replace	VERB
success	NOUN
south	NOUN
analyze	VERB
mark	VERB
lead	NOUN
passenger	NOUN
sensor	NOUN
weather	NOUN
taxi	NOUN
gold	NOUN
look	NOUN
memory	NOUN
tend	VERB
cry	VERB
hit	VERB
total	ADJ
before	ADV
sister	NOUN
spread	VERB
collect	VERB
learning	NOUN
importance	NOUN
protein	NOUN
bill	NOUN
bottom	NOUN
head	VERB
drop	VERB
capacity	NOUN
construction	NOUN
arrest	VERB
south	ADV
belong	VERB
club	NOUN
immediately	ADV
capture	VERB
topic	NOUN
crisis	NOUN
requirement	NOUN
shape	NOUN
approximately	ADV
southern	ADJ
glass	NOUN
unit	NOUN
deal	VERB
realize	VERB
negative	ADJ
generation	NOUN
aim	VERB
hair	NOUN
decade	NOUN
beginning	NOUN
fly	VERB
outcome	NOUN
investment	NOUN
frequency	NOUN
presidential	ADJ
attract	VERB
declare	VERB
fully	ADV
reveal	VERB
hard	ADV
intend	VERB
ice	NOUN
instance	NOUN
cancer	NOUN
participate	VERB
penalty	NOUN
relatively	ADV
ferry	NOUN
respectively	ADV
characteristic	NOUN
scene	NOUN
violence	NOUN
resolution	NOUN
majority	NOUN
domain	NOUN
cheap	ADJ
injury	NOUN
chief	NOUN
engine	NOUN
unknown	ADJ
evening	NOUN
dish	NOUN
kid	NOUN
adopt	VERB
financial	ADJ
stop	NOUN
rich	ADJ
anyone	NOUN
edition	NOUN
critical	ADJ
Chinese	ADJ
journalist	NOUN
overall	ADJ
refuse	VERB
appropriate	ADJ
audience	NOUN
employ	VERB
objective	NOUN
attack	VERB
useful	ADJ
cost	VERB
version	NOUN
handle	VERB
hole	NOUN
control	VERB
estimate	VERB
act	NOUN
suppose	VERB
fresh	ADJ
administration	NOUN
driving	VERB
healthy	ADJ
protest	NOUN
reflect	VERB
opposition	NOUN
fee	NOUN
north	NOUN
pretty	ADV
university	NOUN
principle	NOUN
parking	NOUN
huge	ADJ
charge	VERB
assume	VERB
bag	NOUN
daily	ADJ
scale	NOUN
host	NOUN
significantly	ADV
wave	NOUN
one	PRON
furthermore	ADV
husband	NOUN
digital	ADJ
journey	NOUN
forward	ADV
cook	VERB
chemical	ADJ
contact	NOUN
resistance	NOUN
leg	NOUN
commit	VERB
seed	NOUN
fund	NOUN
failure	NOUN
prove	VERB
conflict	NOUN
love	NOUN
birth	NOUN
basis	NOUN
decrease	VERB
basic	ADJ
gun	NOUN
interested	VERB
survive	VERB
own	VERB
feeling	NOUN
literature	NOUN
calculate	VERB
comfortable	ADJ
robot	NOUN
What	DET
excellent	ADJ
novel	NOUN
wood	NOUN
meal	NOUN
text	NOUN
contact	VERB
relevant	ADJ
sleep	VERB
defeat	VERB
proper	ADJ
agent	NOUN
Check	VERB
extend	VERB
display	VERB
sentence	NOUN
aircraft	NOUN
county	NOUN
French	ADJ
efficiency	NOUN
expensive	ADJ
request	NOUN
sale	NOUN
sight	NOUN
television	NOUN
suffer	VERB
improvement	NOUN
entrance	NOUN
which	DET
possibly	ADV
ward	NOUN
spring	NOUN
mix	VERB
like	SCONJ
responsibility	NOUN
issue	VERB
fit	VERB
destroy	VERB
settle	VERB
consumption	NOUN
implement	VERB
college	NOUN
landscape	NOUN
clinical	ADJ
view	VERB
mission	NOUN
employee	NOUN
perspective	NOUN
link	VERB
typically	ADV
chair	NOUN
budget	NOUN
stuff	NOUN
thousand	NOUN
doctor	NOUN
religion	NOUN
host	VERB
square	NOUN
variable	NOUN
strength	NOUN
selection	NOUN
status	NOUN
wrong	ADJ
dollar	NOUN
play	NOUN
node	NOUN
income	NOUN
association	NOUN
adult	NOUN
prefer	VERB
screen	NOUN
agreement	NOUN
medical	ADJ
railway	NOUN
extremely	ADV
politics	NOUN
festival	NOUN
nor	CCONJ
lady	NOUN
cluster	NOUN
theory	NOUN
widely	ADV
competition	NOUN
help	NOUN
complete	ADJ
search	VERB
coach	NOUN
oppose	VERB
institution	NOUN
point	VERB
store	VERB
west	NOUN
cultural	ADJ
dry	ADJ
divide	VERB
fair	ADJ
software	NOUN
fruit	NOUN
solve	VERB
reduction	NOUN
eventually	ADV
thank	VERB
aware	ADJ
induce	VERB
Internet	NOUN
motor	NOUN
organize	VERB
understanding	NOUN
neighborhood	NOUN
fuel	NOUN
murder	NOUN
combination	NOUN
pair	NOUN
press	VERB
initial	ADJ
bury	VERB
m	NOUN
slowly	ADV
otherwise	ADV
medal	NOUN
score	NOUN
detection	NOUN
notice	VERB
warm	ADJ
regional	ADJ
finger	NOUN
historical	ADJ
exactly	ADV
run	NOUN
approach	VERB
expand	VERB
fan	NOUN
procedure	NOUN
print	VERB
Australian	ADJ
difficulty	NOUN
crowd	NOUN
certainly	ADV
intervention	NOUN
equipment	NOUN
escape	VERB
bomb	NOUN
stick	VERB
panel	NOUN
specifically	ADV
lay	NOUN
religious	ADJ
context	NOUN
beat	VERB
stone	NOUN
regulation	NOUN
perfect	ADJ
finding	VERB
none	NOUN
normal	ADJ
accus	VERB
recorded	VERB
deliver	VERB
address	NOUN
football	NOUN
Italian	ADJ
category	NOUN
preserve	VERB
assessment	NOUN
clean	VERB
depart	VERB
assess	VERB
reporter	NOUN
acid	NOUN
commercial	ADJ
enhance	VERB
potential	NOUN
mental	ADJ
repeat	VERB
publication	NOUN
science	NOUN
forget	VERB
damage	NOUN
reply	VERB
leave	NOUN
input	NOUN
camp	NOUN
Iranian	ADJ
middle	NOUN
extra	ADJ
unless	SCONJ
coat	NOUN
simulation	NOUN
pain	NOUN
standard	NOUN
challenge	VERB
brain	NOUN
agency	NOUN
possibility	NOUN
launch	VERB
gift	NOUN
finding	NOUN
root	NOUN
German	ADJ
bird	NOUN
examine	VERB
English	ADJ
gather	VERB
settlement	NOUN
comparison	NOUN
deny	VERB
appearance	NOUN
answer	NOUN
execute	VERB
transfer	NOUN
protection	NOUN
worry	VERB
whatever	PRON
attach	VERB
ride	VERB
battle	NOUN
quarter	NOUN
ancient	ADJ
zone	NOUN
writer	NOUN
surgery	NOUN
shot	NOUN
originally	ADV
separate	ADJ
friendly	ADJ
spatial	ADJ
voter	NOUN
lawyer	NOUN
laugh	VERB
twice	ADV
cycle	NOUN
accident	NOUN
date	VERB
license	NOUN
grant	VERB
lay	VERB
likely	ADV
suddenly	ADV
restore	VERB
meat	NOUN
researcher	NOUN
pronounce	VERB
convert	VERB
access	VERB
advance	VERB
fun	ADJ
pool	NOUN
manager	NOUN
experiment	NOUN
broad	ADJ
crew	NOUN
variation	NOUN
talk	NOUN
annual	ADJ
frequently	ADV
mouth	NOUN
volume	NOUN
strange	ADJ
agricultural	ADJ
cool	ADJ
touch	VERB
farmer	NOUN
start	NOUN
percent	NOUN
claim	NOUN
cup	NOUN
hire	VERB
load	NOUN
chain	NOUN
Israeli	ADJ
British	ADJ
inform	VERB
billion	NOUN
noise	NOUN
storey	NOUN
height	NOUN
limit	NOUN
formation	NOUN
transportation	NOUN
clothes	NOUN
Click	VERB
call	NOUN
contribution	NOUN
means	NOUN
past	NOUN
integrate	VERB
conversation	NOUN
military	NOUN
freedom	NOUN
dinner	NOUN
wonder	VERB
architecture	NOUN
found	VERB
direct	VERB
cloud	NOUN
crop	NOUN
channel	NOUN
east	NOUN
session	NOUN
tourism	NOUN
biological	ADJ
industrial	ADJ
threaten	VERB
quick	ADJ
western	ADJ
dry	VERB
sustainable	ADJ
actual	ADJ
snow	NOUN
resort	NOUN
either	DET
dedicate	VERB
target	VERB
stream	NOUN
terminal	NOUN
fashion	NOUN
slow	ADJ
trend	NOUN
judge	NOUN
female	ADJ
stem	NOUN
average	ADJ
detect	VERB
participant	NOUN
belief	NOUN
shore	NOUN
slightly	ADV
weekend	NOUN
burn	VERB
schedule	VERB
firm	NOUN
install	VERB
teacher	NOUN
stock	NOUN
possession	NOUN
rural	ADJ
attraction	NOUN
density	NOUN
confidence	NOUN
powerful	ADJ
invite	VERB
contractor	NOUN
essential	ADJ
comment	NOUN
emergency	NOUN
characterize	VERB
household	NOUN
intelligence	NOUN
civil	ADJ
metal	NOUN
profile	NOUN
master	NOUN
drive	NOUN
port	NOUN
exposure	NOUN
turn	NOUN
danger	NOUN
enable	VERB
dangerous	ADJ
exercise	NOUN
highlight	VERB
button	NOUN
Avoid	VERB
breakfast	NOUN
plastic	NOUN
bike	NOUN
clearly	ADV
expert	NOUN
assist	VERB
inspire	VERB
native	ADJ
busy	ADJ
derive	VERB
justice	NOUN
sky	NOUN
grid	NOUN
code	NOUN
politician	NOUN
i	PRON
package	NOUN
copy	NOUN
observation	NOUN
fix	VERB
acquire	VERB
library	NOUN
arrange	VERB
youth	NOUN
schedule	NOUN
camera	NOUN
consequence	NOUN
farm	NOUN
largely	ADV
identity	NOUN
entry	NOUN
alternative	NOUN
hence	ADV
reader	NOUN
fellow	NOUN
baby	NOUN
exchange	NOUN
adult	ADJ
latter	ADJ
actor	NOUN
compose	VERB
email	NOUN
scheme	NOUN
somewhat	ADV
trouble	NOUN
careful	ADJ
compound	NOUN
arrival	NOUN
historic	ADJ
origin	NOUN
hope	NOUN
quiet	ADJ
truth	NOUN
web	NOUN
along	ADV
predict	VERB
magazine	NOUN
evaluation	NOUN
guy	NOUN
expose	VERB
attitude	NOUN
block	NOUN
hide	VERB
airline	NOUN
strongly	ADV
standard	ADJ
rail	NOUN
temple	NOUN
portrait	NOUN
commonly	ADV
accuracy	NOUN
recover	VERB
captain	NOUN
prison	NOUN
properly	ADV
vision	NOUN
consumer	NOUN
housing	NOUN
voltage	NOUN
defend	VERB
anywhere	ADV
reality	NOUN
remaining	VERB
adjust	VERB
shopping	NOUN
fear	NOUN
comic	NOUN
cave	NOUN
subsequently	ADV
present	NOUN
bright	ADJ
fourth	ADJ
excite	VERB
waste	NOUN
leadership	NOUN
territory	NOUN
index	NOUN
award	VERB
Japanese	ADJ
soft	ADJ
wine	NOUN
composition	NOUN
pilot	NOUN
sheet	NOUN
range	VERB
dress	VERB
shoot	VERB
sing	VERB
eliminate	VERB
Sources	NOUN
expedition	NOUN
prisoner	NOUN
carefully	ADV
opening	NOUN
nearby	ADJ
suitable	ADJ
debate	NOUN
at	SCONJ
blog	NOUN
afternoon	NOUN
accompany	VERB
injure	VERB
alcohol	NOUN
test	VERB
flow	VERB
hall	NOUN
coffee	NOUN
spirit	NOUN
emission	NOUN
relative	ADJ
creation	NOUN
conclude	VERB
portion	NOUN
enemy	NOUN
earth	NOUN
ingredient	NOUN
lift	VERB
angle	NOUN
tissue	NOUN
description	NOUN
album	NOUN
match	VERB
occupy	VERB
constant	ADJ
beneficial	ADJ
stick	NOUN
atmosphere	NOUN
impossible	ADJ
admit	VERB
accurate	ADJ
department	NOUN
peak	NOUN
output	NOUN
regard	NOUN
duty	NOUN
sand	NOUN
local	NOUN
websites	NOUN
colony	NOUN
skin	NOUN
distribute	VERB
satisfy	VERB
pathway	NOUN
propose	ADJ
advice	NOUN
cable	NOUN
boundary	NOUN
plate	NOUN
residential	ADJ
construct	VERB
wild	ADJ
proud	ADJ
sex	NOUN
CHAPTER	NOUN
transfer	VERB
hundred	NOUN
biography	NOUN
maximum	ADJ
recipe	NOUN
celebrate	VERB
indicator	NOUN
valley	NOUN
climb	VERB
supporter	NOUN
closely	ADV
frame	NOUN
experimental	ADJ
advance	NOUN
afraid	ADJ
block	VERB
illegal	ADJ
monitor	VERB
sector	NOUN
click	VERB
separate	VERB
assistance	NOUN
thin	ADJ
obviously	ADV
circumstance	NOUN
entirely	ADV
scientific	ADJ
castle	NOUN
clothing	NOUN
cut	NOUN
matrix	NOUN
struck	VERB
qualify	VERB
hurt	VERB
plenty	NOUN
wash	VERB
please	VERB
neither	ADV
yellow	ADJ
progress	NOUN
accessible	ADJ
argue	VERB
practice	VERB
technical	ADJ
emerge	VERB
prominent	ADJ
mistake	NOUN
contract	NOUN
framework	NOUN
mode	NOUN
lip	NOUN
circle	NOUN
partner	NOUN
eastern	ADJ
upper	ADJ
operator	NOUN
professor	NOUN
thick	ADJ
very	ADJ
efficient	ADJ
expansion	NOUN
fairly	ADV
innovation	NOUN
typical	ADJ
prior	ADV
mine	NOUN
filter	NOUN
disorder	NOUN
enzyme	NOUN
doubt	NOUN
craft	NOUN
coverage	NOUN
infrastructure	NOUN
afterwards	ADV
severe	ADJ
priest	NOUN
rice	NOUN
fight	VERB
apparently	ADV
log	NOUN
1st	ADJ
tape	NOUN
attribute	VERB
dress	NOUN
rebel	NOUN
imagine	VERB
respect	VERB
sexual	ADJ
brand	NOUN
earn	VERB
flat	ADJ
painter	NOUN
display	NOUN
rule	VERB
whole	NOUN
colour	NOUN
slave	NOUN
fighting	VERB
rare	ADJ
usual	ADJ
avd	NOUN
transmission	NOUN
cat	NOUN
particle	NOUN
athlete	NOUN
maintenance	NOUN
scientist	NOUN
domestic	ADJ
reportedly	ADV
fault	NOUN
primarily	ADV
promise	VERB
stable	ADJ
knife	NOUN
instrument	NOUN
effectively	ADV
abuse	NOUN
regime	NOUN
tie	VERB
nomination	NOUN
invest	VERB
extensive	ADJ
criterion	NOUN
less	ADJ
alternative	ADJ
Indian	ADJ
hate	VERB
comment	VERB
storm	NOUN
damage	VERB
classification	NOUN
storage	NOUN
command	NOUN
highway	NOUN
radio	NOUN
tall	ADJ
correlation	NOUN
strain	NOUN
human	NOUN
tank	NOUN
east	ADV
long-term	NOUN
guest	NOUN
equal	ADJ
limitation	NOUN
resolve	VERB
beauty	NOUN
depth	NOUN
solar	NOUN
disaster	NOUN
shoulder	NOUN
creature	NOUN
editor	NOUN
sufficient	ADJ
sustainability	NOUN
credit	NOUN
profit	NOUN
diverse	ADJ
fink	VERB
victory	NOUN
while	NOUN
